%%%%%%%
%G....%
%.%.%.%
%.%o%.%
%.%.%.%
%....P%
%%%%%%%
